#T 7 7
#D 2
N N 2 = = = 3
1 - - 3 - 1 |
N N N | N N |
3 - - 5 - - 3
H N N H N N |
H 1 - 4 - 1 |
4 = = = 2 N 1
