#T 7 7
#D 0
2 - - - - - 3
| 1 - 3 - 1 H
| N N | N N H
3 = = 7 = = 5
N N N H 1 N |
2 = = 4 | N |
N 2 = = 4 - 2
