#T 7 7
#D 2
N N N N 1 - 3
2 - 3 - - 2 H
| N | 2 N | 3
| N | H N | |
2 N | 3 - 2 |
| N | N N N |
3 = 5 = 3 - 2
